"Date_evenement";"Hopital_Clinique_Deces2020";"Maison_retraite_Deces2020";"Domicile_Deces2020";"Autre_Deces2020";"Total_Deces2020";"Hopital_Clinique_Deces2019";"Maison_retraite_Deces2019";"Domicile_Deces2019";"Autre_Deces2019";"Total_Deces2019";"Hopital_Clinique_Deces2018";"Maison_retraite_Deces2018";"Domicile_Deces2018";"Autre_Deces2018";"Total_Deces2018";"Zone";"LibelleZone"
"01/01/2020";972;227;472;229;1900;929;197;472;218;1816;1015;251;540;196;2002;"FE";"France"
"02/01/2020";1953;463;946;433;3795;1899;415;970;444;3728;2076;541;1106;390;4113;"FE";"France"
"03/01/2020";2949;706;1439;650;5744;2851;657;1418;652;5578;3159;823;1644;601;6227;"FE";"France"
"04/01/2020";3907;914;1873;874;7568;3863;869;1865;859;7456;4317;1084;2148;812;8361;"FE";"France"
"05/01/2020";4831;1127;2288;1056;9302;4877;1092;2303;1073;9345;5422;1333;2673;1003;10431;"FE";"France"
"06/01/2020";5800;1380;2827;1270;11277;5836;1318;2778;1293;11225;6528;1585;3129;1180;12422;"FE";"France"
"07/01/2020";6827;1633;3301;1503;13264;6881;1538;3262;1510;13191;7570;1833;3627;1376;14406;"FE";"France"
"08/01/2020";7858;1873;3770;1702;15203;7870;1794;3726;1738;15128;8615;2113;4175;1556;16459;"FE";"France"
"09/01/2020";8894;2115;4230;1927;17166;8874;2050;4182;1969;17075;9713;2387;4656;1740;18496;"FE";"France"
"10/01/2020";9894;2355;4705;2143;19097;9876;2275;4661;2194;19006;10764;2632;5126;1918;20440;"FE";"France"
"11/01/2020";10860;2591;5112;2394;20957;10907;2508;5086;2416;20917;11827;2902;5625;2099;22453;"FE";"France"
"12/01/2020";11787;2829;5519;2606;22741;11983;2779;5517;2647;22926;12902;3151;6076;2284;24413;"FE";"France"
"13/01/2020";12747;3036;5940;2829;24552;12979;3029;5969;2866;24843;13928;3398;6577;2469;26372;"FE";"France"
"14/01/2020";13775;3258;6396;3056;26485;13969;3294;6468;3086;26817;14924;3656;7052;2642;28274;"FE";"France"
"15/01/2020";14771;3508;6827;3270;28376;14950;3535;6959;3328;28772;15867;3908;7505;2822;30102;"FE";"France"
"16/01/2020";15755;3738;7255;3507;30255;16009;3787;7397;3553;30746;16880;4147;8001;3023;32051;"FE";"France"
"17/01/2020";16715;3969;7710;3701;32095;17029;4034;7862;3759;32684;17894;4385;8501;3231;34011;"FE";"France"
"18/01/2020";17629;4202;8112;3911;33854;18055;4249;8336;3976;34616;18941;4601;8980;3404;35926;"FE";"France"
"19/01/2020";18556;4406;8521;4096;35579;19039;4508;8771;4207;36525;19922;4863;9488;3588;37861;"FE";"France"
"20/01/2020";19492;4655;8930;4291;37368;19994;4738;9222;4402;38356;20954;5114;9927;3771;39766;"FE";"France"
"21/01/2020";20465;4861;9339;4513;39178;20957;4983;9721;4626;40287;21969;5381;10409;3952;41711;"FE";"France"
"22/01/2020";21412;5077;9757;4725;40971;22042;5225;10211;4852;42330;22968;5632;10877;4099;43576;"FE";"France"
"23/01/2020";22344;5269;10192;4954;42759;23067;5467;10735;5041;44310;23972;5874;11317;4255;45418;"FE";"France"
"24/01/2020";23290;5503;10645;5164;44602;24063;5685;11217;5255;46220;24999;6111;11725;4452;47287;"FE";"France"
"25/01/2020";24240;5729;11077;5363;46409;25140;5917;11721;5462;48240;25980;6375;12150;4639;49144;"FE";"France"
"26/01/2020";25180;5946;11489;5549;48164;26261;6178;12176;5689;50304;26943;6604;12592;4805;50944;"FE";"France"
"27/01/2020";26156;6162;11954;5770;50042;27259;6425;12704;5903;52291;27895;6839;12992;4980;52706;"FE";"France"
"28/01/2020";27108;6402;12363;5985;51858;28284;6676;13259;6151;54370;28851;7069;13365;5126;54411;"FE";"France"
"29/01/2020";28122;6624;12776;6198;53720;29382;6914;13745;6343;56384;29801;7290;13790;5307;56188;"FE";"France"
"30/01/2020";29089;6837;13179;6393;55498;30418;7175;14238;6561;58392;30793;7523;14229;5454;57999;"FE";"France"
"31/01/2020";30092;7079;13588;6590;57349;31513;7421;14727;6759;60420;31824;7733;14639;5612;59808;"FE";"France"
"01/02/2020";31005;7327;13978;6781;59091;32630;7694;15250;6996;62570;32778;7931;15070;5777;61556;"FE";"France"
"02/02/2020";31976;7574;14394;7006;60950;33700;7961;15710;7234;64605;33729;8167;15499;5935;63330;"FE";"France"
"03/02/2020";32933;7795;14872;7237;62837;34680;8221;16169;7431;66501;34663;8369;15919;6104;65055;"FE";"France"
"04/02/2020";33923;8020;15303;7462;64708;35768;8439;16680;7646;68533;35595;8582;16364;6281;66822;"FE";"France"
"05/02/2020";34808;8236;15733;7674;66451;36848;8734;17178;7870;70630;36580;8804;16859;6436;68679;"FE";"France"
"06/02/2020";35762;8488;16131;7882;68263;37929;9009;17698;8089;72725;37563;9034;17338;6603;70538;"FE";"France"
"07/02/2020";36765;8694;16558;8078;70095;38996;9285;18179;8293;74753;38548;9256;17811;6765;72380;"FE";"France"
"08/02/2020";37721;8923;16958;8299;71901;40121;9551;18637;8511;76820;39523;9477;18244;6934;74178;"FE";"France"
"09/02/2020";38647;9148;17347;8476;73618;41193;9830;19097;8742;78862;40501;9715;18666;7140;76022;"FE";"France"
"10/02/2020";39621;9352;17815;8658;75446;42220;10078;19553;8969;80820;41524;9967;19113;7326;77930;"FE";"France"
"11/02/2020";40540;9561;18247;8890;77238;43308;10363;20011;9154;82836;42493;10224;19554;7503;79774;"FE";"France"
"12/02/2020";41524;9761;18650;9099;79034;44337;10618;20476;9377;84808;43443;10452;20026;7671;81592;"FE";"France"
"13/02/2020";42435;10017;19081;9276;80809;45391;10887;20916;9606;86800;44436;10692;20474;7854;83456;"FE";"France"
"14/02/2020";43422;10224;19473;9461;82580;46440;11148;21370;9821;88779;45418;10906;20966;8017;85307;"FE";"France"
"15/02/2020";44343;10443;19884;9669;84339;47509;11419;21835;10034;90797;46389;11109;21397;8198;87093;"FE";"France"
"16/02/2020";45265;10671;20320;9880;86136;48535;11668;22328;10266;92797;47400;11390;21890;8378;89058;"FE";"France"
"17/02/2020";46226;10895;20832;10057;88010;49538;11919;22766;10455;94678;48421;11631;22291;8564;90907;"FE";"France"
"18/02/2020";47153;11140;21231;10245;89769;50550;12175;23276;10688;96689;49323;11884;22722;8740;92669;"FE";"France"
"19/02/2020";48010;11351;21644;10448;91453;51656;12445;23773;10917;98791;50383;12148;23186;8905;94622;"FE";"France"
"20/02/2020";48944;11556;22010;10650;93160;52729;12661;24262;11146;100798;51420;12411;23633;9083;96547;"FE";"France"
"21/02/2020";49909;11766;22391;10855;94921;53753;12904;24739;11367;102763;52460;12655;24050;9238;98403;"FE";"France"
"22/02/2020";50735;11955;22834;11038;96562;54828;13180;25166;11581;104755;53442;12895;24500;9413;100250;"FE";"France"
"23/02/2020";51565;12195;23236;11243;98239;55765;13449;25607;11766;106587;54507;13129;24957;9606;102199;"FE";"France"
"24/02/2020";52471;12418;23664;11427;99980;56715;13695;26030;11980;108420;55510;13392;25426;9793;104121;"FE";"France"
"25/02/2020";53392;12602;24076;11614;101684;57732;13957;26544;12206;110439;56533;13664;25876;9978;106051;"FE";"France"
"26/02/2020";54312;12818;24522;11841;103493;58767;14184;27006;12421;112378;57583;13907;26419;10144;108053;"FE";"France"
"27/02/2020";55243;13054;24927;12036;105260;59785;14431;27489;12630;114335;58617;14169;26913;10320;110019;"FE";"France"
"28/02/2020";56184;13267;25339;12238;107028;60815;14666;27934;12845;116260;59622;14432;27400;10534;111988;"FE";"France"
"29/02/2020";57086;13492;25735;12430;108743;60815;14666;27934;12845;116260;59622;14432;27400;10534;111988;"FE";"France"
"01/03/2020";57999;13694;26191;12641;110525;61818;14892;28359;13063;118132;60684;14736;27968;10736;114124;"FE";"France"
"02/03/2020";58923;13904;26636;12847;112310;62815;15149;28783;13295;120042;61827;15051;28485;10952;116315;"FE";"France"
"03/03/2020";59911;14077;27059;13036;114083;63724;15388;29196;13482;121790;62953;15334;29010;11146;118443;"FE";"France"
"04/03/2020";60881;14266;27515;13237;115899;64713;15640;29649;13668;123670;64033;15645;29521;11334;120533;"FE";"France"
"05/03/2020";61830;14491;27932;13428;117681;65663;15890;30101;13884;125538;65143;15945;30099;11547;122734;"FE";"France"
"06/03/2020";62798;14708;28386;13636;119528;66619;16119;30582;14088;127408;66291;16245;30591;11765;124892;"FE";"France"
"07/03/2020";63671;14901;28816;13834;121222;67610;16381;30996;14280;129267;67407;16518;31095;11926;126946;"FE";"France"
"08/03/2020";64575;15106;29215;14039;122935;68597;16596;31409;14466;131068;68556;16803;31576;12117;129052;"FE";"France"
"09/03/2020";65514;15309;29696;14246;124765;69525;16825;31838;14654;132842;69666;17065;32058;12311;131100;"FE";"France"
"10/03/2020";66491;15535;30128;14448;126602;70348;17051;32255;14856;134510;70744;17368;32560;12514;133186;"FE";"France"
"11/03/2020";67479;15773;30594;14666;128512;71267;17292;32678;15039;136276;71752;17631;33049;12696;135128;"FE";"France"
"12/03/2020";68397;16005;31053;14862;130317;72200;17490;33081;15211;137982;72784;17935;33576;12880;137175;"FE";"France"
"13/03/2020";69336;16204;31473;15095;132108;73095;17703;33481;15394;139673;73840;18216;34016;13083;139155;"FE";"France"
"14/03/2020";70258;16420;31881;15338;133897;74025;17906;33895;15565;141391;74865;18447;34503;13267;141082;"FE";"France"
"15/03/2020";71213;16655;32309;15580;135757;74942;18115;34320;15760;143137;75880;18716;34933;13451;142980;"FE";"France"
"16/03/2020";72253;16919;32772;15816;137760;75855;18327;34743;15932;144857;76925;18972;35363;13627;144887;"FE";"France"
"17/03/2020";73275;17192;33275;16073;139815;76716;18544;35134;16098;146492;77959;19216;35774;13778;146727;"FE";"France"
"18/03/2020";74315;17442;33753;16320;141830;77659;18756;35531;16303;148249;78882;19471;36212;13953;148518;"FE";"France"
"19/03/2020";75396;17731;34262;16571;143960;78551;18969;35924;16489;149933;79825;19750;36633;14133;150341;"FE";"France"
"20/03/2020";76403;17992;34803;16814;146012;79449;19158;36304;16684;151595;80800;19978;37043;14312;152133;"FE";"France"
"21/03/2020";77366;18269;35277;17046;147958;80364;19371;36696;16865;153296;81815;20232;37496;14492;154035;"FE";"France"
"22/03/2020";78353;18567;35795;17259;149974;81250;19583;37084;17067;154984;82850;20475;37936;14667;155928;"FE";"France"
"23/03/2020";79414;18862;36363;17509;152148;82176;19791;37448;17267;156682;83822;20726;38373;14833;157754;"FE";"France"
"24/03/2020";80499;19178;36899;17750;154326;83051;19992;37804;17464;158311;84816;20981;38820;15022;159639;"FE";"France"
"25/03/2020";81663;19497;37501;18009;156670;83905;20210;38210;17651;159976;85792;21206;39275;15183;161456;"FE";"France"
"26/03/2020";82854;19853;38072;18281;159060;84787;20402;38573;17839;161601;86760;21453;39747;15349;163309;"FE";"France"
"27/03/2020";84080;20189;38648;18575;161492;85709;20616;38959;18003;163287;87764;21719;40164;15522;165169;"FE";"France"
"28/03/2020";85280;20617;39271;18856;164024;86607;20830;39349;18191;164977;88697;21951;40647;15701;166996;"FE";"France"
"29/03/2020";86386;21014;39884;19137;166421;87493;21035;39736;18377;166641;89613;22204;41108;15898;168823;"FE";"France"
"30/03/2020";87695;21455;40522;19439;169111;88324;21239;40140;18575;168278;90579;22445;41526;16076;170626;"FE";"France"
"31/03/2020";89040;21914;41166;19747;171867;89188;21404;40536;18769;169897;91494;22683;41977;16240;172394;"FE";"France"
"01/04/2020";90368;22411;41841;20058;174678;90064;21605;40973;18944;171586;92381;22927;42422;16445;174175;"FE";"France"
"02/04/2020";91639;22897;42465;20336;177337;90966;21829;41366;19126;173287;93268;23165;42841;16616;175890;"FE";"France"
"03/04/2020";92952;23390;43116;20656;180114;91853;22038;41761;19321;174973;94191;23409;43339;16802;177741;"FE";"France"
"04/04/2020";94207;23908;43732;20968;182815;92737;22236;42168;19500;176641;95197;23620;43744;16935;179496;"FE";"France"
"05/04/2020";95400;24408;44457;21242;185507;93632;22435;42559;19678;178304;96102;23875;44171;17110;181258;"FE";"France"
"06/04/2020";96664;24920;45117;21528;188229;94500;22632;42940;19881;179953;96993;24120;44588;17288;182989;"FE";"France"
"07/04/2020";97859;25443;45748;21838;190888;95388;22823;43350;20067;181628;97933;24337;44977;17482;184729;"FE";"France"
"08/04/2020";98991;25961;46424;22116;193492;96255;23032;43739;20266;183292;98828;24561;45382;17674;186445;"FE";"France"
"09/04/2020";100200;26436;47020;22355;196011;97087;23240;44139;20448;184914;99716;24772;45842;17850;188180;"FE";"France"
"10/04/2020";101379;26890;47702;22632;198603;97945;23448;44550;20638;186581;100695;25011;46256;18022;189984;"FE";"France"
"11/04/2020";102522;27318;48311;22894;201045;98790;23659;44929;20810;188188;101627;25236;46629;18198;191690;"FE";"France"
"12/04/2020";103555;27729;48892;23138;203314;99641;23847;45324;20999;189811;102553;25472;47042;18357;193424;"FE";"France"
"13/04/2020";104677;28115;49511;23392;205695;100470;24021;45704;21171;191366;103436;25683;47448;18527;195094;"FE";"France"
"14/04/2020";105764;28488;50133;23655;208040;101289;24183;46069;21344;192885;104295;25889;47836;18690;196710;"FE";"France"
"15/04/2020";106864;28866;50679;23891;210300;102147;24384;46455;21523;194509;105160;26098;48284;18835;198377;"FE";"France"
"16/04/2020";107889;29255;51218;24128;212490;103043;24581;46830;21722;196176;106029;26333;48693;19014;200069;"FE";"France"
"17/04/2020";109017;29638;51786;24371;214812;103991;24790;47223;21899;197903;106846;26540;49124;19201;201711;"FE";"France"
"18/04/2020";110052;29985;52321;24609;216967;104873;24983;47588;22073;199517;107764;26731;49500;19364;203359;"FE";"France"
"19/04/2020";111007;30326;52815;24841;218989;105740;25187;47992;22277;201196;108694;26962;49905;19544;205105;"FE";"France"
"20/04/2020";111906;30629;53303;25058;220896;106640;25410;48371;22451;202872;109616;27195;50326;19730;206867;"FE";"France"
"21/04/2020";112822;30936;53795;25262;222815;107480;25612;48708;22637;204437;110513;27434;50746;19929;208622;"FE";"France"
"22/04/2020";113790;31226;54253;25452;224721;108375;25806;49095;22820;206096;111348;27639;51110;20103;210200;"FE";"France"
"23/04/2020";114732;31488;54743;25650;226613;109225;25988;49512;23057;207782;112212;27831;51487;20271;211801;"FE";"France"
"24/04/2020";115693;31762;55190;25836;228481;110154;26192;49929;23250;209525;113051;28028;51883;20443;213405;"FE";"France"
"25/04/2020";116592;32019;55670;26034;230315;110994;26405;50310;23460;211169;113929;28209;52254;20590;214982;"FE";"France"
"26/04/2020";117428;32250;56124;26237;232039;111860;26606;50679;23645;212790;114793;28415;52602;20729;216539;"FE";"France"
"27/04/2020";118257;32479;56556;26436;233728;112710;26816;51014;23812;214352;115631;28619;52961;20896;218107;"FE";"France"
"28/04/2020";119118;32706;57010;26653;235487;113582;27017;51360;23982;215941;116470;28808;53354;21058;219690;"FE";"France"
"29/04/2020";119950;32931;57464;26843;237188;114404;27197;51750;24144;217495;117310;28998;53763;21193;221264;"FE";"France"
"30/04/2020";120767;33125;57926;27006;238824;115252;27382;52111;24307;219052;118158;29174;54151;21343;222826;"FE";"France"
"01/05/2020";121512;33337;58345;27169;240363;116131;27594;52487;24500;220712;118980;29356;54502;21472;224310;"FE";"France"
"02/05/2020";122321;33544;58778;27343;241986;116986;27787;52880;24701;222354;119829;29527;54885;21651;225892;"FE";"France"
"03/05/2020";123075;33781;59216;27499;243571;117809;27981;53278;24879;223947;120622;29717;55244;21778;227361;"FE";"France"
"04/05/2020";123890;33978;59705;27697;245270;118658;28158;53648;25070;225534;121512;29909;55628;21952;229001;"FE";"France"
"05/05/2020";124700;34181;60147;27897;246925;119441;28327;54019;25256;227043;122353;30110;56019;22122;230604;"FE";"France"
"06/05/2020";125504;34390;60565;28089;248548;120352;28526;54412;25436;228726;123194;30313;56391;22285;232183;"FE";"France"
"07/05/2020";126298;34564;61024;28268;250154;121209;28724;54801;25630;230364;124022;30515;56779;22456;233772;"FE";"France"
"08/05/2020";127124;34754;61424;28464;251766;122046;28943;55171;25801;231961;124836;30710;57156;22622;235324;"FE";"France"
"09/05/2020";127907;34943;61836;28620;253306;122886;29138;55564;25966;233554;125702;30890;57499;22763;236854;"FE";"France"
"10/05/2020";128675;35162;62261;28782;254880;123800;29317;55944;26161;235222;126482;31072;57828;22907;238289;"FE";"France"
"11/05/2020";129427;35351;62677;28952;256407;124586;29501;56317;26343;236747;127346;31218;58215;23081;239860;"FE";"France"
"12/05/2020";130208;35536;63112;29121;257977;125426;29707;56685;26497;238315;128144;31391;58585;23252;241372;"FE";"France"
"13/05/2020";131005;35739;63537;29298;259579;126225;29890;57083;26654;239852;128873;31571;58922;23400;242766;"FE";"France"
"14/05/2020";131744;35942;63975;29468;261129;127073;30082;57467;26836;241458;129673;31724;59283;23561;244241;"FE";"France"
"15/05/2020";132568;36120;64412;29679;262779;127959;30277;57847;26991;243074;130481;31889;59644;23713;245727;"FE";"France"
"16/05/2020";133382;36316;64789;29880;264367;128804;30466;58236;27181;244687;131295;32086;60013;23873;247267;"FE";"France"
"17/05/2020";134113;36517;65209;30051;265890;129682;30636;58633;27364;246315;132145;32261;60378;24034;248818;"FE";"France"
"18/05/2020";134939;36714;65631;30228;267512;130545;30827;58997;27577;247946;133000;32445;60762;24186;250393;"FE";"France"
"19/05/2020";135783;36920;66094;30415;269212;131364;31034;59363;27755;249516;133810;32636;61105;24360;251911;"FE";"France"
"20/05/2020";136646;37095;66534;30626;270901;132223;31229;59775;27934;251161;134628;32833;61470;24513;253444;"FE";"France"
"21/05/2020";137538;37325;66970;30799;272632;133077;31409;60151;28107;252744;135479;33018;61817;24683;254997;"FE";"France"
"22/05/2020";138360;37544;67406;31009;274319;133925;31588;60497;28289;254299;136290;33226;62200;24820;256536;"FE";"France"
"23/05/2020";139137;37752;67820;31181;275890;134793;31789;60878;28497;255957;137170;33426;62567;24981;258144;"FE";"France"
"24/05/2020";139790;37921;68205;31344;277260;135705;31975;61239;28686;257605;138049;33603;62936;25145;259733;"FE";"France"
"25/05/2020";140536;38102;68615;31539;278792;136515;32152;61578;28867;259112;138887;33808;63299;25303;261297;"FE";"France"
"26/05/2020";141341;38313;68988;31719;280361;137292;32322;61938;29023;260575;139724;34014;63682;25479;262899;"FE";"France"
"27/05/2020";142086;38524;69376;31893;281879;138135;32503;62275;29206;262119;140578;34216;64039;25635;264468;"FE";"France"
"28/05/2020";142879;38749;69774;32075;283477;138979;32676;62616;29380;263651;141444;34411;64432;25783;266070;"FE";"France"
"29/05/2020";143652;38944;70176;32232;285004;139813;32854;62948;29530;265145;142314;34599;64793;25937;267643;"FE";"France"
"30/05/2020";144376;39150;70556;32406;286488;140590;33024;63276;29707;266597;143123;34800;65155;26117;269195;"FE";"France"
"31/05/2020";145130;39355;70901;32568;287954;141437;33211;63614;29891;268153;143910;34964;65518;26288;270680;"FE";"France"
"01/06/2020";145878;39576;71281;32745;289480;142319;33376;63928;30104;269727;144726;35132;65861;26437;272156;"FE";"France"
"02/06/2020";146640;39794;71735;32910;291079;143122;33577;64301;30282;271282;145571;35328;66187;26607;273693;"FE";"France"
"03/06/2020";147448;40003;72094;33075;292620;143985;33763;64684;30459;272891;146369;35500;66572;26772;275213;"FE";"France"
"04/06/2020";148286;40202;72498;33229;294215;144842;33941;65034;30644;274461;147202;35654;66952;26910;276718;"FE";"France"
"05/06/2020";149059;40378;72863;33372;295672;145668;34105;65354;30845;275972;147983;35832;67281;27062;278158;"FE";"France"
"06/06/2020";149884;40564;73234;33546;297228;146505;34258;65703;31002;277468;148819;36001;67621;27193;279634;"FE";"France"
"07/06/2020";150549;40739;73608;33701;298597;147331;34410;66035;31174;278950;149610;36188;67965;27338;281101;"FE";"France"
"08/06/2020";151276;40916;73985;33868;300045;148134;34559;66390;31351;280434;150471;36365;68322;27511;282669;"FE";"France"
"09/06/2020";152083;41126;74356;34038;301603;148882;34742;66733;31525;281882;151278;36541;68650;27673;284142;"FE";"France"
"10/06/2020";152867;41302;74742;34191;303102;149670;34892;67085;31695;283342;152086;36696;68988;27817;285587;"FE";"France"
"11/06/2020";153721;41505;75144;34317;304687;150467;35062;67453;31858;284840;152883;36890;69355;27963;287091;"FE";"France"
"12/06/2020";154513;41696;75549;34467;306225;151301;35232;67783;32008;286324;153705;37071;69710;28122;288608;"FE";"France"
"13/06/2020";155261;41909;75951;34640;307761;152120;35428;68118;32212;287878;154511;37218;70036;28262;290027;"FE";"France"
"14/06/2020";156016;42124;76323;34784;309247;152972;35609;68439;32358;289378;155272;37380;70384;28425;291461;"FE";"France"
"15/06/2020";156792;42322;76714;34953;310781;153825;35776;68827;32516;290944;156093;37563;70731;28564;292951;"FE";"France"
"16/06/2020";157613;42525;77093;35121;312352;154648;35946;69173;32694;292461;156881;37736;71061;28727;294405;"FE";"France"
"17/06/2020";158355;42731;77474;35281;313841;155537;36108;69547;32889;294081;157637;37902;71425;28874;295838;"FE";"France"
"18/06/2020";159121;42950;77870;35439;315380;156398;36297;69872;33065;295632;158365;38088;71788;29039;297280;"FE";"France"
"19/06/2020";159909;43133;78253;35591;316886;157271;36462;70243;33267;297243;159234;38261;72115;29195;298805;"FE";"France"
"20/06/2020";160675;43324;78632;35765;318396;158124;36634;70600;33432;298790;160050;38441;72516;29355;300362;"FE";"France"
"21/06/2020";161479;43526;78999;35947;319951;158964;36801;70923;33579;300267;160897;38617;72880;29523;301917;"FE";"France"
"22/06/2020";162278;43754;79418;36130;321580;159751;36967;71262;33749;301729;161699;38788;73254;29682;303423;"FE";"France"
"23/06/2020";163123;43991;79817;36314;323245;160534;37163;71614;33914;303225;162468;38945;73579;29835;304827;"FE";"France"
"24/06/2020";163955;44192;80212;36498;324857;161393;37341;71972;34090;304796;163238;39112;73938;30009;306297;"FE";"France"
"25/06/2020";164849;44435;80617;36682;326583;162267;37500;72356;34248;306371;164014;39302;74296;30165;307777;"FE";"France"
"26/06/2020";165731;44629;81063;36895;328318;163149;37686;72719;34451;308005;164893;39480;74654;30338;309365;"FE";"France"
"27/06/2020";166499;44845;81451;37088;329883;164010;37861;73096;34675;309642;165777;39664;75012;30518;310971;"FE";"France"
"28/06/2020";167211;45043;81824;37254;331332;164892;38034;73507;34876;311309;166618;39873;75395;30702;312588;"FE";"France"
"29/06/2020";167893;45229;82221;37404;332747;165755;38221;73902;35062;312940;167505;40057;75747;30861;314170;"FE";"France"
"30/06/2020";168643;45411;82601;37578;334233;166645;38418;74308;35265;314636;168324;40264;76108;31031;315727;"FE";"France"
"01/07/2020";169415;45586;82977;37755;335733;167464;38609;74766;35450;316289;169225;40450;76534;31233;317442;"FE";"France"
"02/07/2020";170203;45759;83352;37925;337239;168286;38766;75135;35628;317815;170073;40662;76943;31410;319088;"FE";"France"
"03/07/2020";170959;45925;83689;38092;338665;169100;38931;75510;35811;319352;170974;40851;77346;31594;320765;"FE";"France"
"04/07/2020";171660;46109;84033;38267;340069;169928;39092;75876;35994;320890;171843;41045;77720;31755;322363;"FE";"France"
"05/07/2020";172424;46315;84410;38462;341611;170774;39279;76243;36164;322460;172707;41224;78098;31907;323936;"FE";"France"
"06/07/2020";173209;46474;84809;38609;343101;171678;39467;76611;36347;324103;173541;41398;78453;32054;325446;"FE";"France"
"07/07/2020";173994;46649;85186;38775;344604;172472;39645;76985;36537;325639;174354;41571;78819;32222;326966;"FE";"France"
"08/07/2020";174722;46829;85570;38945;346066;173244;39788;77317;36737;327086;175128;41729;79178;32419;328454;"FE";"France"
"09/07/2020";175543;47044;85953;39133;347673;174062;39958;77676;36904;328600;175974;41914;79532;32584;330004;"FE";"France"
"10/07/2020";176360;47251;86372;39325;349308;174866;40106;77989;37090;330051;176808;42070;79933;32744;331555;"FE";"France"
"11/07/2020";177097;47430;86710;39507;350744;175738;40274;78376;37279;331667;177598;42252;80272;32884;333006;"FE";"France"
"12/07/2020";177870;47608;87037;39684;352199;176607;40433;78737;37460;333237;178392;42419;80611;33056;334478;"FE";"France"
"13/07/2020";178662;47771;87404;39848;353685;177437;40617;79066;37646;334766;179202;42614;80934;33240;335990;"FE";"France"
"14/07/2020";179443;47979;87752;40023;355197;178206;40796;79401;37797;336200;180034;42800;81250;33398;337482;"FE";"France"
"15/07/2020";180236;48163;88105;40187;356691;178932;40948;79759;37973;337612;180834;42977;81609;33553;338973;"FE";"France"
"16/07/2020";181016;48343;88442;40359;358160;179777;41102;80069;38138;339086;181664;43193;82016;33700;340573;"FE";"France"
"17/07/2020";181814;48541;88802;40526;359683;180643;41268;80415;38295;340621;182493;43372;82379;33873;342117;"FE";"France"
"18/07/2020";182565;48719;89161;40685;361130;181480;41435;80777;38479;342171;183337;43563;82707;34058;343665;"FE";"France"
"19/07/2020";183298;48911;89521;40860;362590;182330;41609;81131;38675;343745;184202;43736;83102;34230;345270;"FE";"France"
"20/07/2020";184095;49118;89918;41031;364162;183175;41797;81509;38879;345360;185027;43941;83442;34380;346790;"FE";"France"
"21/07/2020";184828;49289;90344;41217;365678;183915;41950;81858;39087;346810;185872;44106;83774;34539;348291;"FE";"France"
"22/07/2020";185634;49482;90693;41374;367183;184761;42121;82239;39255;348376;186657;44297;84070;34695;349719;"FE";"France"
"23/07/2020";186458;49670;91048;41560;368736;185599;42334;82600;39461;349994;187514;44450;84459;34836;351259;"FE";"France"
"24/07/2020";187272;49895;91411;41740;370318;186487;42567;82999;39643;351696;188412;44610;84822;34992;352836;"FE";"France"
"25/07/2020";188115;50092;91797;41906;371910;187455;42791;83443;39868;353557;189327;44840;85184;35165;354516;"FE";"France"
"26/07/2020";188912;50291;92140;42068;373411;188425;43011;83929;40060;355425;190200;45046;85536;35337;356119;"FE";"France"
"27/07/2020";189710;50482;92544;42235;374971;189239;43202;84280;40248;356969;191140;45228;85923;35531;357822;"FE";"France"
"28/07/2020";190511;50701;92915;42415;376542;190035;43377;84603;40428;358443;192001;45437;86265;35714;359417;"FE";"France"
"29/07/2020";191305;50905;93284;42581;378075;190779;43548;84980;40588;359895;192810;45626;86610;35873;360919;"FE";"France"
"30/07/2020";192130;51124;93665;42765;379684;191606;43688;85321;40747;361362;193663;45824;86986;36047;362520;"FE";"France"
"31/07/2020";193025;51363;94078;42967;381433;192373;43848;85635;40921;362777;194480;46017;87367;36216;364080;"FE";"France"
"01/08/2020";193854;51599;94458;43134;383045;193176;44044;85983;41076;364279;195313;46206;87758;36366;365643;"FE";"France"
"02/08/2020";194620;51788;94817;43329;384554;193981;44218;86357;41256;365812;196118;46369;88105;36539;367131;"FE";"France"
"03/08/2020";195370;51982;95198;43482;386032;194785;44402;86697;41437;367321;196966;46537;88486;36696;368685;"FE";"France"
"04/08/2020";196174;52162;95544;43640;387520;195575;44590;87018;41632;368815;197849;46730;88885;36872;370336;"FE";"France"
"05/08/2020";196960;52330;95895;43814;388999;196350;44775;87386;41797;370308;198656;46929;89286;37054;371925;"FE";"France"
"06/08/2020";197822;52523;96266;44001;390612;197200;44974;87734;41963;371871;199478;47151;89728;37238;373595;"FE";"France"
"07/08/2020";198667;52701;96674;44191;392233;198009;45143;88093;42143;373388;200383;47388;90155;37437;375363;"FE";"France"
"08/08/2020";199493;52909;97068;44411;393881;198839;45320;88408;42330;374897;201290;47588;90559;37587;377024;"FE";"France"
"09/08/2020";200354;53109;97496;44604;395563;199723;45527;88766;42512;376528;202114;47772;90930;37743;378559;"FE";"France"
"10/08/2020";201261;53343;97969;44823;397396;200507;45715;89106;42674;378002;202924;47916;91261;37893;379994;"FE";"France"
"11/08/2020";202187;53577;98409;45048;399221;201261;45886;89434;42832;379413;203694;48064;91597;38055;381410;"FE";"France"
"12/08/2020";203129;53817;98859;45254;401059;202012;46055;89781;43006;380854;204461;48260;91972;38231;382924;"FE";"France"
"13/08/2020";204040;54053;99292;45463;402848;202797;46219;90106;43159;382281;205256;48446;92339;38394;384435;"FE";"France"
"14/08/2020";204853;54265;99698;45633;404449;203565;46406;90429;43338;383738;206089;48611;92705;38555;385960;"FE";"France"
"15/08/2020";205703;54483;100072;45807;406065;204344;46590;90756;43504;385194;206827;48793;93027;38698;387345;"FE";"France"
"16/08/2020";206492;54696;100468;45985;407641;205122;46765;91123;43671;386681;207618;48959;93375;38855;388807;"FE";"France"
"17/08/2020";207283;54898;100817;46133;409131;205912;46959;91488;43834;388193;208413;49130;93730;39031;390304;"FE";"France"
"18/08/2020";208122;55088;101211;46306;410727;206638;47153;91832;44031;389654;209199;49292;94004;39200;391695;"FE";"France"
"19/08/2020";208928;55291;101572;46473;412264;207433;47297;92184;44201;391115;209909;49464;94342;39378;393093;"FE";"France"
"20/08/2020";209771;55488;101919;46664;413842;208241;47499;92501;44376;392617;210701;49647;94727;39567;394642;"FE";"France"
"21/08/2020";210590;55680;102293;46841;415404;209045;47676;92883;44537;394141;211588;49832;95096;39700;396216;"FE";"France"
"22/08/2020";211373;55880;102647;47026;416926;209817;47824;93196;44711;395548;212458;50022;95438;39871;397789;"FE";"France"
"23/08/2020";212123;56073;103009;47201;418406;210670;48002;93548;44914;397134;213291;50247;95782;40037;399357;"FE";"France"
"24/08/2020";212931;56277;103421;47364;419993;211481;48173;93947;45103;398704;214071;50429;96155;40197;400852;"FE";"France"
"25/08/2020";213700;56439;103814;47549;421502;212275;48365;94330;45300;400270;214879;50597;96486;40355;402317;"FE";"France"
"26/08/2020";214554;56652;104186;47716;423108;213107;48572;94682;45491;401852;215617;50775;96828;40492;403712;"FE";"France"
"27/08/2020";215391;56841;104570;47875;424677;213983;48800;95049;45673;403505;216419;50935;97196;40680;405230;"FE";"France"
"28/08/2020";216238;57055;104952;48047;426292;214860;49000;95401;45885;405146;217256;51117;97569;40870;406812;"FE";"France"
"29/08/2020";217079;57237;105257;48215;427788;215754;49204;95730;46045;406733;218096;51295;97944;41050;408385;"FE";"France"
"30/08/2020";217794;57417;105596;48397;429204;216623;49399;96094;46249;408365;218858;51457;98299;41193;409807;"FE";"France"
"31/08/2020";218615;57567;105963;48573;430718;217409;49578;96431;46422;409840;219672;51634;98626;41345;411277;"FE";"France"
"01/09/2020";219410;57752;106360;48734;432256;218147;49785;96802;46616;411350;220432;51810;98950;41484;412676;"FE";"France"
"02/09/2020";220218;57931;106720;48900;433769;218921;49969;97145;46791;412826;221191;51987;99297;41609;414084;"FE";"France"
"03/09/2020";221055;58119;107093;49056;435323;219736;50149;97506;46923;414314;221976;52165;99659;41762;415562;"FE";"France"
"04/09/2020";221940;58316;107503;49239;436998;220516;50358;97852;47114;415840;222823;52351;100022;41926;417122;"FE";"France"
"05/09/2020";222781;58512;107884;49448;438625;221264;50516;98192;47284;417256;223680;52554;100396;42103;418733;"FE";"France"
"06/09/2020";223558;58682;108268;49609;440117;222060;50675;98540;47454;418729;224497;52730;100775;42291;420293;"FE";"France"
"07/09/2020";224366;58898;108669;49781;441714;222875;50860;98881;47630;420246;225340;52933;101150;42476;421899;"FE";"France"
"08/09/2020";225254;59094;109047;49940;443335;223660;51024;99213;47818;421715;226094;53110;101468;42642;423314;"FE";"France"
"09/09/2020";226121;59317;109452;50109;444999;224448;51203;99574;48012;423237;226912;53290;101813;42825;424840;"FE";"France"
"10/09/2020";226974;59531;109849;50290;446644;225239;51403;99939;48181;424762;227736;53477;102168;43025;426406;"FE";"France"
"11/09/2020";227872;59752;110212;50469;448305;226059;51575;100303;48376;426313;228560;53658;102542;43205;427965;"FE";"France"
"12/09/2020";228683;59948;110617;50686;449934;226857;51781;100675;48544;427857;229410;53845;102900;43377;429532;"FE";"France"
"13/09/2020";229574;60160;111016;50857;451607;227723;51973;101028;48726;429450;230257;54031;103294;43549;431131;"FE";"France"
"14/09/2020";230455;60390;111422;51054;453321;228517;52174;101385;48894;430970;231077;54223;103632;43730;432662;"FE";"France"
"15/09/2020";231414;60635;111866;51233;455148;229301;52392;101750;49072;432515;231887;54422;103982;43898;434189;"FE";"France"
"16/09/2020";232290;60859;112306;51407;456862;230153;52589;102124;49268;434134;232644;54598;104335;44050;435627;"FE";"France"
"17/09/2020";233127;61101;112727;51574;458529;230999;52800;102492;49456;435747;233454;54779;104741;44215;437189;"FE";"France"
"18/09/2020";234079;61331;113131;51746;460287;231782;52970;102839;49635;437226;234255;54986;105094;44374;438709;"FE";"France"
"19/09/2020";234994;61578;113543;51940;462055;232602;53157;103197;49818;438774;235061;55175;105491;44544;440271;"FE";"France"
"20/09/2020";235824;61806;113988;52108;463726;233476;53368;103554;50024;440422;235924;55380;105858;44698;441860;"FE";"France"
"21/09/2020";236668;62018;114407;52290;465383;234322;53573;103959;50220;442074;236744;55592;106225;44847;443408;"FE";"France"
"22/09/2020";237498;62237;114780;52456;466971;235141;53783;104338;50401;443663;237535;55786;106581;44995;444897;"FE";"France"
"23/09/2020";238333;62418;115200;52596;468547;235937;53984;104703;50566;445190;238338;55996;106921;45148;446403;"FE";"France"
"24/09/2020";239162;62609;115635;52745;470151;236723;54172;105044;50720;446659;239078;56172;107298;45324;447872;"FE";"France"
"25/09/2020";239972;62806;116056;52901;471735;237570;54360;105410;50875;448215;239882;56366;107650;45480;449378;"FE";"France"
"26/09/2020";240771;63003;116461;53080;473315;238387;54583;105778;51077;449825;240656;56540;107995;45640;450831;"FE";"France"
"27/09/2020";241556;63202;116893;53232;474883;239199;54770;106133;51249;451351;241542;56723;108363;45815;452443;"FE";"France"
"28/09/2020";242438;63408;117364;53390;476600;240010;54949;106528;51430;452917;242417;56938;108740;45990;454085;"FE";"France"
"29/09/2020";243322;63632;117798;53553;478305;240803;55137;106892;51613;454445;243219;57159;109092;46169;455639;"FE";"France"
"30/09/2020";244197;63870;118277;53714;480058;241615;55336;107274;51797;456022;244017;57336;109406;46343;457102;"FE";"France"
"01/10/2020";245104;64107;118749;53879;481839;242498;55530;107652;51971;457651;244847;57522;109819;46486;458674;"FE";"France"
"02/10/2020";245969;64341;119246;54030;483586;243383;55702;108030;52144;459259;245682;57723;110193;46653;460251;"FE";"France"
"03/10/2020";246856;64563;119703;54201;485323;244232;55876;108418;52339;460865;246539;57921;110595;46810;461865;"FE";"France"
"04/10/2020";247743;64756;120189;54345;487033;245075;56065;108803;52518;462461;247457;58146;110973;47008;463584;"FE";"France"
"05/10/2020";248614;64989;120622;54504;488729;245925;56244;109177;52699;464045;248355;58355;111334;47185;465229;"FE";"France"
"06/10/2020";249543;65216;121110;54673;490542;246749;56443;109576;52875;465643;249227;58582;111744;47350;466903;"FE";"France"
"07/10/2020";250447;65417;121557;54824;492245;247594;56610;109980;53057;467241;249993;58790;112103;47535;468421;"FE";"France"
"08/10/2020";251306;65641;122047;54992;493986;248442;56804;110383;53236;468865;250757;58984;112493;47707;469941;"FE";"France"
"09/10/2020";252251;65871;122542;55160;495824;249275;57003;110756;53420;470454;251638;59170;112912;47876;471596;"FE";"France"
"10/10/2020";253151;66103;122986;55284;497524;250117;57205;111151;53602;472075;252512;59385;113300;48061;473258;"FE";"France"
"11/10/2020";253973;66327;123429;55423;499152;251064;57402;111503;53771;473740;253379;59611;113713;48241;474944;"FE";"France"
"12/10/2020";254885;66554;123909;55563;500911;251907;57626;111873;53961;475367;254261;59826;114106;48417;476610;"FE";"France"
"13/10/2020";255759;66759;124402;55713;502633;252767;57851;112254;54139;477011;255096;60036;114499;48580;478211;"FE";"France"
"14/10/2020";256645;66972;124876;55866;504359;253599;58045;112679;54358;478681;255942;60265;114869;48741;479817;"FE";"France"
"15/10/2020";257578;67201;125375;56006;506160;254474;58253;113061;54534;480322;256792;60461;115307;48916;481476;"FE";"France"
"16/10/2020";258519;67422;125898;56147;507986;255354;58451;113480;54706;481991;257700;60652;115700;49063;483115;"FE";"France"
"17/10/2020";259454;67663;126422;56298;509837;256225;58632;113830;54897;483584;258581;60842;116063;49224;484710;"FE";"France"
"18/10/2020";260323;67903;126916;56455;511597;257103;58819;114183;55099;485204;259390;61049;116441;49400;486280;"FE";"France"
"19/10/2020";261283;68149;127421;56612;513465;257948;59021;114550;55291;486810;260234;61243;116801;49564;487842;"FE";"France"
"20/10/2020";262301;68401;127955;56755;515412;258758;59227;114940;55510;488435;261047;61428;117157;49724;489356;"FE";"France"
"21/10/2020";263407;68659;128501;56910;517477;259572;59431;115367;55683;490053;261815;61611;117519;49893;490838;"FE";"France"
"22/10/2020";264476;68943;129018;57087;519524;260394;59641;115751;55876;491662;262622;61801;117928;50047;492398;"FE";"France"
"23/10/2020";265498;69235;129557;57248;521538;261319;59824;116143;56045;493331;263490;61993;118327;50226;494036;"FE";"France"
"24/10/2020";266434;69518;130089;57434;523475;262204;60027;116532;56219;494982;264332;62180;118719;50416;495647;"FE";"France"
"25/10/2020";267481;69806;130651;57613;525551;263091;60236;116953;56401;496681;265202;62375;119104;50626;497307;"FE";"France"
"26/10/2020";268469;70052;131198;57786;527505;263936;60467;117312;56597;498312;266040;62568;119474;50801;498883;"FE";"France"
"27/10/2020";269547;70345;131765;57941;529598;264756;60673;117685;56780;499894;266892;62780;119834;50980;500486;"FE";"France"
"28/10/2020";270620;70640;132345;58110;531715;265594;60865;118107;56952;501518;267762;62963;120198;51179;502102;"FE";"France"
"29/10/2020";271712;70968;132898;58304;533882;266441;61085;118479;57123;503128;268625;63180;120561;51334;503700;"FE";"France"
"30/10/2020";272786;71273;133485;58487;536031;267326;61301;118850;57314;504791;269536;63381;121014;51518;505449;"FE";"France"
"31/10/2020";273866;71579;134086;58651;538182;268213;61527;119235;57486;506461;270457;63584;121416;51667;507124;"FE";"France"
"01/11/2020";274992;71899;134698;58832;540421;269120;61721;119642;57682;508165;271280;63783;121799;51856;508718;"FE";"France"
"02/11/2020";276162;72219;135323;59006;542710;270033;61924;120049;57879;509885;272101;63988;122177;52055;510321;"FE";"France"
"03/11/2020";277284;72541;135905;59179;544909;270902;62128;120453;58060;511543;272936;64197;122539;52247;511919;"FE";"France"
"04/11/2020";278392;72890;136499;59337;547118;271816;62306;120871;58268;513261;273785;64414;122915;52426;513540;"FE";"France"
"05/11/2020";279486;73270;137071;59521;549348;272681;62499;121273;58437;514890;274709;64620;123343;52622;515294;"FE";"France"
"06/11/2020";280662;73595;137675;59708;551640;273576;62707;121687;58630;516600;275594;64839;123759;52798;516990;"FE";"France"
"07/11/2020";281807;73947;138329;59894;553977;274476;62896;122115;58842;518329;276506;65037;124175;52985;518703;"FE";"France"
"08/11/2020";282952;74317;138936;60078;556283;275374;63088;122482;59009;519953;277382;65225;124573;53170;520350;"FE";"France"
"09/11/2020";284104;74634;139609;60241;558588;276353;63295;122884;59206;521738;278227;65458;124940;53326;521951;"FE";"France"
"10/11/2020";285226;75005;140199;60405;560835;277231;63484;123260;59394;523369;279146;65658;125304;53519;523627;"FE";"France"
"11/11/2020";286336;75359;140783;60569;563047;278027;63691;123623;59573;524914;279985;65854;125707;53709;525255;"FE";"France"
"12/11/2020";287475;75700;141414;60750;565339;278906;63909;124051;59788;526654;280866;66070;126120;53891;526947;"FE";"France"
"13/11/2020";288640;76048;142017;60926;567631;279795;64134;124480;59980;528389;281804;66290;126520;54080;528694;"FE";"France"
"14/11/2020";289719;76408;142619;61098;569844;280708;64375;124889;60188;530160;282674;66507;126871;54248;530300;"FE";"France"
"15/11/2020";290769;76766;143212;61255;572002;281683;64586;125273;60381;531923;283546;66705;127254;54442;531947;"FE";"France"
"16/11/2020";291900;77120;143830;61428;574278;282613;64793;125655;60585;533646;284397;66907;127617;54611;533532;"FE";"France"
"17/11/2020";293007;77462;144366;61614;576449;283541;65002;126061;60764;535368;285228;67108;128027;54797;535160;"FE";"France"
"18/11/2020";294108;77816;144948;61810;578682;284392;65261;126500;60967;537120;286028;67326;128422;54963;536739;"FE";"France"
"19/11/2020";295241;78182;145517;61986;580926;285340;65486;126892;61176;538894;286846;67516;128861;55132;538355;"FE";"France"
"20/11/2020";296310;78518;146029;62159;583016;286249;65713;127311;61368;540641;287681;67741;129278;55311;540011;"FE";"France"
"21/11/2020";297355;78832;146590;62320;585097;287175;65935;127713;61570;542393;288540;67961;129693;55502;541696;"FE";"France"
"22/11/2020";298419;79153;147162;62502;587236;288143;66151;128165;61797;544256;289394;68170;130074;55683;543321;"FE";"France"
"23/11/2020";299516;79481;147778;62688;589463;289074;66394;128585;62014;546067;290296;68390;130493;55854;545033;"FE";"France"
"24/11/2020";300649;79804;148338;62886;591677;289917;66643;128994;62193;547747;291187;68615;130927;56037;546766;"FE";"France"
"25/11/2020";301722;80111;148895;63077;593805;290841;66875;129409;62402;549527;292071;68812;131350;56220;548453;"FE";"France"
"26/11/2020";302808;80443;149422;63268;595941;291825;67081;129852;62594;551352;292948;69024;131755;56397;550124;"FE";"France"
"27/11/2020";303903;80755;150019;63443;598120;292804;67289;130292;62771;553156;293831;69237;132192;56562;551822;"FE";"France"
"28/11/2020";304901;81100;150551;63619;600171;293701;67490;130702;62971;554864;294764;69420;132612;56737;553533;"FE";"France"
"29/11/2020";305884;81380;151091;63788;602143;294657;67751;131111;63164;556683;295670;69601;133036;56907;555214;"FE";"France"
"30/11/2020";306928;81682;151638;63988;604236;295531;67996;131515;63353;558395;296557;69806;133442;57088;556893;"FE";"France"
"01/12/2020";307999;81968;152174;64177;606318;296359;68215;131871;63571;560016;297459;70018;133830;57305;558612;"FE";"France"
"02/12/2020";309060;82247;152726;64369;608402;297219;68439;132317;63777;561752;298280;70254;134255;57491;560280;"FE";"France"
"03/12/2020";310166;82564;153293;64564;610587;298160;68656;132737;63987;563540;299168;70460;134675;57668;561971;"FE";"France"
"04/12/2020";311238;82870;153846;64748;612702;299091;68865;133129;64200;565285;300074;70682;135077;57824;563657;"FE";"France"
"05/12/2020";312256;83152;154410;64932;614750;300035;69082;133535;64403;567055;300952;70888;135481;58010;565331;"FE";"France"
"06/12/2020";313299;83437;154992;65119;616847;300929;69262;133952;64598;568741;301839;71107;135858;58187;566991;"FE";"France"
"07/12/2020";314331;83709;155510;65313;618863;301859;69468;134375;64813;570515;302710;71324;136261;58362;568657;"FE";"France"
"08/12/2020";315405;84011;156060;65488;620964;302739;69693;134776;65001;572209;303603;71532;136634;58530;570299;"FE";"France"
"09/12/2020";316490;84309;156635;65657;623091;303615;69922;135244;65200;573981;304444;71730;137004;58682;571860;"FE";"France"
"10/12/2020";317568;84612;157174;65847;625201;304534;70131;135687;65387;575739;305257;71948;137422;58851;573478;"FE";"France"
"11/12/2020";318669;84920;157756;66056;627401;305416;70374;136086;65581;577457;306109;72150;137838;59045;575142;"FE";"France"
"12/12/2020";319718;85216;158312;66238;629484;306342;70610;136534;65805;579291;307026;72363;138271;59223;576883;"FE";"France"
"13/12/2020";320711;85516;158861;66405;631493;307319;70838;136975;66023;581155;307903;72567;138656;59418;578544;"FE";"France"
"14/12/2020";321737;85795;159487;66578;633597;308269;71101;137384;66221;582975;308700;72768;139087;59631;580186;"FE";"France"
"15/12/2020";322792;86105;160054;66758;635709;309122;71310;137801;66441;584674;309585;72952;139483;59834;581854;"FE";"France"
"16/12/2020";323834;86403;160616;66936;637789;309958;71546;138215;66665;586384;310481;73157;139924;60042;583604;"FE";"France"
"17/12/2020";324805;86715;161095;67137;639752;310944;71784;138657;66846;588231;311349;73365;140403;60256;585373;"FE";"France"
"18/12/2020";325817;86978;161626;67333;641754;311890;72013;139099;67058;590060;312305;73583;140819;60441;587148;"FE";"France"
"19/12/2020";326803;87251;162112;67499;643665;312824;72245;139528;67275;591872;313219;73818;141257;60649;588943;"FE";"France"
"20/12/2020";327831;87535;162630;67657;645653;313805;72452;139968;67487;593712;314114;74041;141696;60858;590709;"FE";"France"
"21/12/2020";328831;87801;163127;67811;647570;314757;72678;140389;67694;595518;315015;74279;142114;61048;592456;"FE";"France"
"22/12/2020";329874;88109;163652;67976;649611;315653;72898;140850;67899;597300;315914;74496;142505;61247;594162;"FE";"France"
"23/12/2020";330947;88387;164141;68139;651614;316559;73114;141321;68092;599086;316777;74727;142942;61435;595881;"FE";"France"
"24/12/2020";331960;88665;164654;68308;653587;317483;73338;141764;68273;600858;317669;74960;143371;61600;597600;"FE";"France"
"25/12/2020";332922;88930;165192;68437;655481;318371;73558;142193;68476;602598;318539;75163;143796;61797;599295;"FE";"France"
"26/12/2020";333931;89214;165711;68587;657443;319278;73782;142650;68688;604398;319396;75384;144236;61998;601014;"FE";"France"
"27/12/2020";334968;89470;166241;68751;659430;320222;73990;143101;68899;606212;320315;75596;144679;62198;602788;"FE";"France"
"28/12/2020";336046;89764;166817;68906;661533;321152;74236;143535;69115;608038;321310;75807;145104;62401;604622;"FE";"France"
"29/12/2020";337102;90050;167310;69055;663517;322065;74433;143937;69304;609739;322196;76017;145534;62597;606344;"FE";"France"
"30/12/2020";338175;90310;167772;69216;665473;323023;74698;144391;69511;611623;323054;76257;145979;62793;608083;"FE";"France"
"31/12/2020";339178;90561;168222;69360;667321;323969;74940;144810;69703;613422;324002;76500;146438;63006;609946;"FE";"France"
